0 0 2 3 4 0
0 0 2 3 4 0
1 1 5 3 4 0
0 6 5 0 7 7
0 6 0 0 0 0
8 8 0 0 0 0
