0 0 2 0 3 3
0 0 2 0 0 4
1 1 2 0 0 4
0 5 6 6 6 4
0 5 7 7 8 0
0 0 0 0 8 0