0 2 0 3 4 5
0 2 0 3 4 5
1 1 0 3 4 0
0 0 0 0 6 6
0 0 0 0 7 7
0 0 0 0 8 8