2 3 3 4 4 0
2 0 5 0 0 0
1 1 5 6 7 0
0 0 0 6 7 0
8 8 8 6 7 0
0 0 0 0 0 0