0 0 2 3 3 3
0 0 2 0 0 0
1 1 2 0 0 0
4 0 5 5 0 6
4 0 0 0 7 6
8 8 8 0 7 6